    100111 111 111 111111
11111000100010001000011
   1000000001111111111111111
1111111111111
