WE ./path_to_the_west_texture
SO ./path_to_the_south_texture
EA ./path_to_the_east_texture
NO ./path_to_the_north_texture

	1111111111111111111111
1111000000000000111000000111111
1000000000000000000000000001
1000000000000000001111111111
1111111111111111111
